WWWWWWWWWWWWWWW
WDDDDWDDDWDDDDW
WBDWDDDDDDDWDBW
WDDDDWWWWWDDDDW
WDWWDDDDDDDWWDW
WDDDDWWWWWDDDDW
WWWWDDDDDDDWWWW
WDDDDWWTWWDDDDW
WWWWDWTSTWDWWWW
WDDDDWSASWDDDDW
WDWDWWWWWWWDWDW
WDWDTTTPTTTDWDW
WDWWTTTTTTTWWDW
WDBDDDWWWDDDBDW
WWWWWWWWWWWWWWW