wwwwwwwwwwwwwww
wDDDDDWWWDDDDDW
wDWWWDDDDDWWWDW
wDWWDDWWWDDWWDW
wDDDDDDDDDDDDDW
wDWWDWWTWWDWWDW
wDDDDWTSTWDDDDW
wwDWDWSASWDWDWW
wDDDDWWWWWDDDDW
wDWWWDWWWDWWWDW
wDDDDDWDWDDDDDW
wWDWWDDDDDWWDWW
wDDDWDTTTDWDDDW
wDDDDDTPTDDDDDW
wWWDWWDWDWWDWWW
wDDDDDDWDDDDDDW
wwwwwwwwwwwwwww