WWWWWWWWWWWWWWWWWWWWW
WDDDDDDDDDWDDDDDDDDDW
WDWWWWWWDWWWDWWDWWWDW
WDWDDDDDDDWDDDDDDDWDW
WDDDDDDDDDDDDDDDDDDDW
WDWWWDDDDDDDDDDDWWWDW
WDDWWWDDDDDDDDDWWWDDW
WDDDWWWDWWTWWDWWWDDDW
WDDDDDDDWTSTWDDDDDDDW
WDWWWWWWWSASWWWWWWWDW
WDDDDDDDWWWWWDDDDDDDW
WWDWDDDDDDDDDDDDDWDWW
WDDWWDDDDTTTDDDDWWDDW
WDWWWWDDDTPTDDDWWWWDW
WDDDDDDDDTTTDDDDDDDDW
WDWWDWWDDDDDDDWWDWWDW
WDDDDWWWDWWWDWWWDDDDW
WWWWWWWWWWWWWWWWWWWWW