WWWWWWWWWWWWWWW
WTTTTWTTTWTTTTW
WBTWTTTTTTTWTBW
WTTTTWWWWWTTTTW
WTWWTTTTTTTWWTW
WTTTTWWWWWTTTTW
WWWWTTTTTTTWWWW
TTTTTWWUWWTTTTT
WWWWTWUSUWTWWWW
WTTTTWRARWTTTTW
WTWTWWWWWWWTWTW
WTWTUUUPUUUTWTW
WTWWUUUUUUUWWTW
WTBTTTWWWTTTBTW
WWWWWWWWWWWWWWW